level=1
mapWidth=25
mapHeight=19
tileWidth=32
tileHeight=32
textureFile=W1,assets/wall1.jpg,True,wall
textureFile=F1,assets/floor1.jpg,False,None
textureFile=D1,assets/door1.jpg,True,wall
textureFile=D2,assets/floor1.jpg,False,None
textureFile=B1,assets/button1.jpg,False,button
textureFile=B2,assets/button2.jpg,False,button
activator=9,15,False,B1,B2,door,None,button
playerStart=392,294
block=288,288
mapLine="W1W1W1W1W1W1W1W1W1W1W1W1W1W1W1W1W1W1W1W1W1W1W1W1W1"
mapLine="W1W1W1W1W1W1W1W1W1W1W1W1W1W1W1W1W1W1W1W1W1W1W1W1W1"
mapLine="W1W1W1W1W1W1W1W1W1W1W1W1W1W1W1W1W1W1W1W1W1W1W1W1W1"
mapLine="W1W1W1W1W1W1W1W1W1W1W1W1W1W1W1W1W1W1W1W1W1W1W1W1W1"
mapLine="W1W1W1W1W1W1W1W1W1W1W1W1W1W1W1W1W1W1W1W1W1W1W1W1W1"
mapLine="W1W1W1W1W1F1F1F1F1F1F1F1F1F1F1F1F1F1F1F1W1W1W1W1W1"
mapLine="W1W1W1W1W1F1F1F1F1F1F1F1F1F1F1F1F1F1F1F1W1W1W1W1W1"
mapLine="W1W1W1W1W1F1F1F1F1F1F1F1F1F1F1F1F1F1F1F1W1W1W1W1W1"
mapLine="W1W1W1W1W1F1F1F1F1F1F1F1F1F1F1F1F1F1F1F1D1F1F1F1F1"
mapLine="W1W1W1W1W1F1F1F1F1F1F1F1F1F1F1B1F1F1F1F1D1F1F1F1F1"
mapLine="W1W1W1W1W1F1F1F1F1F1F1F1F1F1F1F1F1F1F1F1D1F1F1F1F1"
mapLine="W1W1W1W1W1F1F1F1F1F1F1F1F1F1F1F1F1F1F1F1W1W1W1W1W1"
mapLine="W1W1W1W1W1F1F1F1F1F1F1F1F1F1F1F1F1F1F1F1W1W1W1W1W1"
mapLine="W1W1W1W1W1F1F1F1F1F1F1F1F1F1F1F1F1F1F1F1W1W1W1W1W1"
mapLine="W1W1W1W1W1W1W1W1W1W1W1W1W1W1W1W1W1W1W1W1W1W1W1W1W1"
mapLine="W1W1W1W1W1W1W1W1W1W1W1W1W1W1W1W1W1W1W1W1W1W1W1W1W1"
mapLine="W1W1W1W1W1W1W1W1W1W1W1W1W1W1W1W1W1W1W1W1W1W1W1W1W1"
mapLine="W1W1W1W1W1W1W1W1W1W1W1W1W1W1W1W1W1W1W1W1W1W1W1W1W1"
mapLine="W1W1W1W1W1W1W1W1W1W1W1W1W1W1W1W1W1W1W1W1W1W1W1W1W1"
